1111111111111111111
10000000C0000001111
1011011111000001111
11010000C0000001111
11P1000000000E01111
10011111101100000C1
1111111111111111111