111111111111111111111111111111
10000000C00X000011110C00000001
100101111100000011111110C00001
10010000C0001X0011110X00000001
10P100000X000E0000000000011101
100C11111011000000C11111111111
111111111111111111111111111111