111111111111111111111111111111
10000000C001000011110C00000001
100101111100010011111110C00001
10010000C000100011110100000001
10P1000001000E0000000000011101
100C11111011000000C11111111111
100000000000000100000000000111
1000011C00000001C0000000000011
111111111111111111111111111111