1111111111111111111
1000000000000001111
1001011111000001111
1001000000000011111
10P1000000000E01111
1000111110110000001
1111111111111111111