11111111111111111111
10000000C00X00001111
10010111110001001111
10010000C00010001111
10P100000X000E001111
100C11111011000000C1
11111111111111111111