1111111111111111111
10000000C0000001111
1001011111000001111
10010000C00W0011111
10P1000000000E01111
10001111101100000C1
1111111111111111111