11111111111111
11111111111111
11111111111111
11111111111111
10000000C00001
10010111110001
11010000C00001
11P100000E0001
10011111101101
11111111111111
11111111111111
11111111111111
11111111111111
11111111111111