1111111111111111111
1000000000000001111
1001011111000001111
1001000000000011111
10E1000000000C01111
1000111110110000001
1111111111111111111