1111111111111111111
10000000C0000001111
1001011111000001111
11110000C0000001111
11P0000000000E01111
1001111110110000XC1
1111111111111111111