1111111
1001001
1000001
1100001
1000C01
1000111
1000PC1
1111111